************
*          *
*  *    *  *
*          *
*  ******  *
*          *
************
